  ####
###  ###
#   *$ #
# #  # #
#   ** #
###  #@#
  # ** #
  #  # #
  # *. #
  #  ###
  #### 
